- Column Properties = カラムプロパティ
- The width, offset, push, and pull settings for each column. =各カラムの幅、オフセット、プッシュ、プル等の設定
- size = サイズ
- width = 幅
- offset = オフセット
- push = プッシュ
- pull = プル
- add column = カラム追加
- Auto adjust columns = カラム自動調整
- Will automatically adjust columns based on if nested components are hidden. =ネスト化されたコンポーネントが非表示になることによって、カラムを自動調整する。
- Hide Label = ラベルの非表示
- Hide the label (title, if no label) of this component. This allows you to show - the label in the form builder, but not when it is rendered. =このコンポーネントのラベルを非表示にする。これにより、フォームビルダーでラベルを表示できるが、レンダリング時に表示することはできない。
- Number of Rows = 行数
- Enter the number or rows that should be displayed by this table. =このテーブルで表示したい行数を入力する。
- Number of Columns = カラム数
- Enter the number or columns that should be displayed by this table. = このテーブルで表示したいカラム数を入力する。
- Clone Row Components = 行のコンポーネントクローン 
- Check this if you would like 'CLONE'... = 必要に応じてチェックする
- Cell Alignment =セルの配置 
- Horizontal alignment for cells of the table. = テーブルのセルを横配置する。
- Striped = ストライプ
- This will stripe the table if checked. = チェックを入れると、テーブルがストライプ化される。
- Bordered = ボーダー
- This will border the table if checked. = チェックを入れると、テーブルの枠線が表示される。
- Hover = ホバー
- Highlight a row on hover. = ホバーで行を強調表示する。
- Condensed = コンデンス
- Condense the size of the table. = テーブルのサイズを縮小する
- left = 左
- right = 正しい
- center = 中心
